0 0 0 0 0 0 0 0 0 0 0 0 0 0 0 0 0 0 0 0 0 0 0 0 9 0 0 0 0 0 0 0 0 0 0 0 0 0 0 0 0 0 0 0 0 0 0 0 0 0 0
0 1 1 5 1 1 4 5 1 5 1 1 1 1 1 3 1 1 1 1 1 1 1 6 13 7 3 1 1 1 4 4 1 1 1 1 1 1 1 1 1 1 1 1 1 1 1 1 1 1 0
0 1 1 4 1 4 1 1 1 1 1 1 1 1 1 1 1 1 1 3 3 1 1 6 13 7 1 1 1 1 5 1 1 1 1 1 1 1 4 1 1 4 1 5 1 1 1 1 1 1 0
0 1 1 1 1 1 3 1 5 1 4 1 1 4 1 1 1 1 1 1 1 1 1 3 2 1 1 1 1 5 1 1 4 1 4 1 1 1 1 1 1 1 1 1 1 1 3 5 1 1 0
0 1 1 1 1 1 1 1 1 1 1 3 1 5 1 1 1 1 1 1 1 1 1 1 2 3 1 1 1 1 1 3 1 1 1 4 1 1 1 1 1 1 1 1 1 1 1 1 1 1 0
0 1 1 1 1 1 1 1 1 1 1 1 1 1 1 1 1 1 1 1 4 1 1 1 2 1 1 1 5 1 1 1 4 3 1 1 1 4 1 1 1 1 1 1 1 1 5 1 1 1 0
0 1 1 1 1 5 1 1 1 1 1 1 1 1 1 5 1 1 1 1 3 1 1 1 2 1 1 1 1 1 1 1 5 1 1 1 1 1 1 1 1 1 1 1 1 1 1 1 1 3 0
0 1 1 1 1 1 4 1 1 1 5 1 1 1 1 1 5 1 1 1 1 1 1 1 2 1 1 1 1 5 1 1 1 1 4 1 1 1 1 1 1 1 1 1 1 1 1 1 1 1 0
0 1 1 1 1 3 1 1 1 5 1 1 3 1 1 1 1 1 1 1 1 1 1 1 2 1 1 1 1 1 1 1 1 1 4 4 1 1 1 4 1 1 1 1 1 1 1 1 1 1 0
0 1 1 1 1 1 1 1 1 1 1 1 4 1 1 1 1 1 1 1 1 1 1 1 2 1 3 1 1 1 4 1 1 1 1 1 1 1 1 1 1 1 1 1 1 1 1 1 1 4 0
0 1 1 1 1 1 1 4 1 1 5 1 1 3 1 1 1 1 1 1 1 1 1 5 2 4 1 1 1 1 1 1 1 1 1 1 1 1 1 1 1 1 1 1 1 1 1 1 1 4 0
0 1 1 1 1 1 1 1 1 1 1 1 1 1 1 1 1 1 1 1 1 1 1 1 2 3 1 1 1 1 1 4 1 1 1 1 1 1 4 1 1 1 1 1 1 1 1 1 1 1 0
0 1 1 1 1 1 1 1 4 1 1 4 1 1 4 1 1 1 1 1 1 1 1 1 2 1 1 1 1 1 1 1 1 1 1 1 5 1 1 1 1 1 5 1 1 1 1 1 1 1 0
0 1 1 1 1 1 1 1 5 3 1 1 1 1 5 1 1 5 1 1 1 1 1 1 2 1 1 1 1 1 1 1 1 1 1 1 1 1 1 1 1 1 4 1 1 1 1 1 1 1 0
0 3 1 1 1 1 1 1 1 5 1 1 1 4 1 1 1 1 5 3 1 1 1 5 2 1 1 1 1 1 1 1 1 1 1 3 1 1 1 1 4 1 4 1 1 5 5 1 1 1 0
0 1 1 1 1 1 1 4 1 1 1 3 1 1 1 1 1 1 1 1 1 1 1 1 2 1 1 1 1 1 4 1 1 4 1 1 1 1 1 4 1 1 1 1 1 5 1 1 1 1 0
0 1 1 1 1 1 1 1 1 1 1 1 1 1 1 1 1 1 1 1 1 1 3 1 2 1 1 1 1 1 1 1 1 1 1 1 1 1 5 1 5 1 5 5 1 1 1 1 1 4 0
0 1 1 1 1 1 1 1 1 1 1 1 1 1 1 1 5 5 1 1 1 1 3 4 2 1 1 1 4 4 1 1 1 5 3 1 1 1 3 1 1 1 4 1 1 1 1 1 1 1 0
0 1 1 5 1 1 1 1 1 1 1 1 1 1 1 1 1 1 1 1 1 1 1 1 2 1 4 1 1 1 1 1 1 1 1 1 1 1 1 1 1 5 1 1 1 1 1 1 1 5 0
0 1 3 3 1 1 1 5 1 1 1 1 1 1 3 1 5 1 1 1 1 4 1 1 2 1 1 1 1 1 1 1 1 1 1 1 1 1 1 1 1 1 1 1 1 1 1 3 1 1 0
0 1 1 1 1 5 1 1 1 5 1 1 1 1 1 4 1 1 10 5 10 1 1 1 2 1 1 1 1 5 1 1 1 1 4 1 1 1 1 1 5 1 1 1 3 1 1 1 1 1 0
0 1 1 1 1 1 1 1 1 1 1 1 1 1 4 10 3 4 10 1 10 10 10 1 2 1 4 4 5 1 1 1 1 1 3 5 1 1 3 1 1 1 1 1 1 1 1 1 1 1 0
0 1 3 1 1 1 3 1 3 3 1 1 4 1 1 3 1 1 3 1 1 1 10 1 2 1 3 1 1 1 1 1 1 1 3 1 1 1 1 1 1 1 4 1 1 1 1 1 1 1 0
0 1 1 1 1 1 3 1 1 1 1 1 1 1 1 1 1 1 1 1 1 1 10 11 7 1 3 1 1 1 1 3 1 1 5 1 1 3 1 1 1 1 1 1 4 1 1 1 1 4 0
0 1 1 1 1 1 1 1 1 1 1 1 1 1 1 3 4 1 1 1 1 1 1 1 2 1 1 1 1 3 1 1 1 1 1 1 1 1 4 1 1 1 1 1 1 1 1 1 1 1 0
0 1 1 3 4 1 1 1 1 1 1 1 1 1 1 1 1 1 1 1 1 1 1 4 2 4 1 1 1 1 1 1 1 1 1 1 4 1 1 1 1 1 3 1 1 1 4 1 1 1 0
0 1 4 1 1 1 1 3 1 1 4 1 1 1 1 1 1 4 1 1 4 3 1 1 2 1 1 1 4 1 1 1 4 4 1 1 1 3 1 5 1 1 1 1 1 4 4 4 1 1 0
0 1 1 1 1 1 1 5 1 1 1 1 4 1 5 1 1 1 1 1 1 1 3 1 2 1 1 1 1 1 1 1 1 1 1 1 4 1 3 1 1 1 1 1 1 1 1 1 1 1 0
0 3 1 1 1 1 1 1 1 1 1 1 1 1 1 1 1 1 1 1 1 3 1 1 2 1 1 1 1 3 1 1 1 1 1 1 1 1 1 1 1 1 1 1 1 1 1 1 1 1 0
0 1 1 1 4 1 1 1 1 1 1 5 1 1 1 1 3 1 1 1 1 1 1 1 2 1 1 1 1 1 3 3 1 1 1 1 3 1 1 1 1 1 1 1 1 1 1 1 3 1 0
0 5 1 4 1 1 1 1 1 4 1 1 1 1 1 1 1 4 1 5 1 1 5 1 2 1 1 1 1 1 1 1 1 4 1 1 1 1 1 1 1 1 4 1 1 4 1 1 1 1 0
0 1 1 1 1 3 1 5 5 5 1 4 1 1 1 1 1 1 1 3 1 1 3 3 2 1 1 4 1 1 1 3 1 1 1 1 1 1 1 1 1 1 1 1 1 3 1 1 1 1 0
0 1 3 1 1 3 1 1 1 5 1 1 1 1 1 1 3 3 1 5 1 1 1 1 2 1 1 1 1 1 1 1 1 3 1 4 1 4 1 1 1 1 1 1 1 1 1 1 1 1 0
0 1 1 1 1 1 3 1 4 1 1 1 1 1 1 1 3 1 1 1 1 1 1 1 2 1 1 1 1 1 1 1 1 3 3 1 1 1 1 1 1 1 1 1 1 4 1 1 1 1 0
0 1 5 1 1 1 1 1 1 1 1 1 1 1 1 4 3 1 1 1 1 1 5 1 2 1 1 1 1 1 1 1 1 1 5 1 1 1 1 4 1 1 1 1 1 1 1 1 4 1 0 
0 1 1 1 1 1 1 1 1 1 1 1 5 1 1 1 1 1 1 1 1 1 1 3 2 1 1 5 1 3 1 1 5 1 1 1 3 1 1 1 1 1 1 3 1 1 1 1 1 1 0
0 1 5 1 1 1 1 1 1 1 1 1 1 1 1 1 1 1 1 5 1 1 1 5 2 1 1 1 1 1 1 1 1 1 1 1 4 1 5 1 1 1 1 3 1 1 1 1 1 1 0
0 1 1 4 1 1 1 1 1 1 1 1 1 1 3 3 5 1 1 1 1 1 1 1 2 1 1 1 1 1 1 3 1 1 1 1 1 1 1 1 1 1 1 1 1 1 1 1 1 1 0
0 1 5 1 1 5 1 1 1 1 1 1 1 1 1 1 1 5 4 3 4 1 1 1 2 1 4 1 1 1 1 1 1 1 1 1 1 1 1 1 5 1 1 3 1 1 1 1 1 1 0
0 1 5 1 3 1 1 1 1 1 1 1 1 4 1 1 1 1 3 1 1 1 1 1 2 1 1 1 5 1 5 1 1 1 1 1 1 1 1 1 1 1 1 1 1 1 1 1 1 3 0
0 5 1 1 1 1 3 1 1 1 1 1 4 1 1 1 3 1 1 1 1 1 1 4 2 1 1 1 1 1 1 5 1 1 1 1 1 1 1 1 1 3 1 1 4 1 1 1 4 1 0
0 1 1 5 1 1 1 1 1 1 1 1 4 1 1 1 1 1 1 1 1 1 1 1 2 1 1 5 1 1 1 5 1 3 1 5 1 1 1 1 4 1 1 1 1 1 1 1 1 1 0
0 1 1 1 1 1 1 1 1 1 3 1 1 1 1 1 3 1 1 1 1 1 1 1 2 3 1 1 1 1 1 1 1 5 1 1 1 1 3 1 1 1 1 1 1 1 1 5 1 1 0
0 1 1 1 4 1 1 1 1 4 1 1 1 1 1 1 1 1 1 1 1 1 5 1 2 1 1 1 4 1 1 1 4 5 1 1 3 1 5 1 1 1 4 1 1 1 3 1 4 1 0
0 1 3 4 1 1 1 1 1 1 1 1 1 3 1 5 1 1 1 1 1 3 1 1 2 4 1 1 1 1 1 1 1 1 1 1 1 1 1 1 1 1 1 1 1 1 1 1 1 1 0
0 1 4 1 1 3 1 3 1 1 1 4 1 1 5 1 1 1 1 1 1 3 1 1 2 4 1 1 5 1 3 1 1 1 1 3 1 1 1 1 1 1 1 1 4 1 1 1 3 1 0
0 1 1 1 1 1 5 3 3 1 1 1 1 1 1 1 1 1 4 1 1 1 1 1 2 1 1 1 1 1 1 1 1 1 1 1 1 1 3 5 1 1 1 1 1 1 1 3 3 1 0
0 1 5 1 1 1 1 4 1 1 3 4 1 1 1 1 1 1 1 1 1 1 4 4 2 1 1 1 1 1 1 1 1 1 1 1 3 1 1 1 1 1 1 1 5 1 1 1 4 1 0
0 1 1 1 4 3 1 1 1 1 1 1 1 1 1 1 1 1 1 1 1 3 1 1 2 1 5 1 1 1 1 5 1 1 1 1 1 1 1 1 1 1 1 1 3 1 1 1 1 1 0
0 1 1 1 5 3 4 1 1 5 1 1 1 1 1 1 1 1 3 1 1 1 3 1 2 1 1 1 1 3 1 1 1 1 1 1 1 1 1 1 1 1 1 1 1 1 1 1 1 1 0
0 0 0 0 0 0 0 0 0 0 0 0 0 0 0 0 0 0 0 0 0 0 0 0 0 0 0 0 0 0 0 0 0 0 0 0 0 0 0 0 0 0 0 0 0 0 0 0 0 0 0