0 0 0 0 0 0 0 0 0 0 0 0 0 0 0 0 0 0 0 0 0 0 0 0 0 0 0 0 0 0 0 0 0 0 0 0 0 0 0 0 0 0 0 0 0 0 0 0 0 0 
0 1 12 1 1 1 1 1 11 1 1 1 1 1 1 1 1 1 1 1 1 1 1 1 1 1 1 1 10 1 1 1 1 1 11 1 1 1 10 1 1 1 11 1 1 1 10 1 12 0 
0 1 12 1 10 1 11 10 10 1 12 11 10 10 11 1 10 10 10 10 12 11 12 11 11 10 10 10 10 1 12 12 12 1 10 1 11 1 10 1 10 1 12 1 10 1 12 1 10 0 
0 1 1 1 11 1 1 1 10 1 1 1 12 1 1 1 11 1 1 1 1 1 1 1 1 1 1 1 1 1 12 1 10 1 1 1 11 1 10 1 11 1 1 1 11 1 1 1 11 0 
0 1 12 12 12 12 11 1 12 11 10 1 10 1 11 12 10 1 10 10 10 10 10 11 10 11 12 10 11 11 12 1 12 10 11 12 10 1 12 1 10 12 12 10 11 12 10 1 11 0 
0 1 12 1 1 1 12 1 1 1 12 1 11 1 1 1 10 1 1 1 11 1 1 1 1 1 1 1 1 1 1 1 1 1 12 1 1 1 12 1 1 1 12 1 1 1 1 1 12 0 
0 10 11 1 12 1 10 1 12 1 10 1 10 11 12 1 11 12 10 1 12 1 12 12 12 1 12 11 12 12 12 11 11 11 12 1 12 10 10 10 10 1 10 1 10 10 11 11 12 0 
0 1 1 1 10 1 1 1 11 1 11 1 1 1 11 1 1 1 11 1 1 1 12 1 1 1 11 1 1 1 12 1 1 1 1 1 11 1 1 1 1 1 10 1 1 1 1 1 11 0 
0 1 12 1 11 11 12 10 11 1 11 1 12 11 12 1 12 1 12 1 12 12 11 12 11 10 10 1 11 1 10 1 12 10 10 10 12 1 11 11 10 10 12 11 11 10 12 10 11 0 
0 1 12 1 12 1 1 1 11 1 12 1 12 1 1 1 10 1 12 1 11 1 1 1 1 1 1 1 12 1 11 1 12 1 1 1 10 1 1 1 1 1 1 1 1 1 1 1 10 0 
0 1 12 12 10 1 12 1 11 11 10 1 10 1 12 10 10 1 10 1 11 1 11 12 12 12 11 11 12 1 12 1 12 1 12 1 11 1 10 10 12 10 12 10 11 12 12 1 12 0 
0 1 1 1 1 1 11 1 1 1 1 1 10 1 1 1 12 1 12 1 10 1 10 1 1 1 1 1 1 1 1 1 10 1 12 1 11 1 11 1 1 1 10 1 1 1 1 1 12 0 
0 12 12 12 11 10 12 12 12 11 12 1 12 12 11 1 11 10 12 1 11 1 12 11 12 10 11 12 10 12 12 10 10 1 11 1 11 1 10 12 10 1 10 1 12 12 12 1 11 0 
0 1 1 1 1 1 12 1 1 1 11 1 11 1 1 1 12 1 1 1 11 1 1 1 1 1 1 1 10 1 1 1 1 1 10 1 12 1 10 1 1 1 11 1 10 1 1 1 12 0 
0 1 11 12 10 1 11 1 10 1 12 1 12 1 12 12 11 1 10 12 10 12 11 11 10 12 12 1 12 12 10 1 11 11 10 1 11 1 10 1 12 1 12 1 10 1 10 10 11 0 
0 1 11 1 1 1 1 1 10 1 11 1 12 1 1 1 12 1 1 1 12 1 1 1 12 1 12 1 1 1 10 1 1 1 11 1 12 1 11 1 10 1 12 1 10 1 1 1 10 0 
0 1 12 12 12 12 12 11 10 1 12 1 10 10 12 1 11 11 11 1 10 1 12 1 12 1 10 12 12 1 10 1 10 1 11 12 12 1 12 1 12 1 12 1 11 11 11 1 10 0 
0 1 12 1 1 1 11 1 1 1 12 1 10 1 1 1 1 1 10 1 11 1 12 1 10 1 12 1 1 1 11 1 11 1 12 1 1 1 11 1 10 1 10 1 1 1 12 1 12 0 
0 1 10 1 12 1 11 11 11 1 10 11 11 1 11 12 11 11 12 1 11 1 10 1 11 1 11 1 12 12 11 1 10 1 12 1 12 10 11 1 11 1 11 10 10 1 11 1 11 0 
0 1 1 1 10 1 1 1 10 1 1 1 1 1 12 1 1 1 1 1 1 1 11 1 1 1 12 1 10 1 10 1 10 1 1 1 11 1 1 1 11 1 11 1 1 1 12 1 11 0 
0 1 10 10 10 12 10 1 12 1 10 12 11 11 12 1 10 11 10 10 11 11 11 11 11 1 10 1 10 1 10 1 11 10 11 10 10 10 11 1 11 12 10 1 12 11 10 1 10 0 
0 1 11 1 10 1 1 1 10 1 11 1 1 1 1 1 12 1 10 1 1 1 10 1 1 1 10 1 12 1 12 1 1 1 10 1 1 1 12 1 1 1 12 1 12 1 12 1 12 0 
0 1 12 1 10 1 11 11 11 12 10 1 12 10 10 12 10 1 10 1 10 1 12 11 10 12 11 1 11 1 12 12 12 1 12 1 11 1 12 12 11 1 12 1 10 1 10 1 12 0 
0 1 1 1 10 1 12 1 1 1 1 1 11 1 1 1 1 1 11 1 10 1 1 1 1 1 1 1 11 1 1 1 11 1 1 1 12 1 12 1 1 1 12 1 11 1 12 1 10 0 
0 1 12 11 10 1 10 1 12 12 11 12 12 1 10 11 10 1 12 1 10 11 12 1 11 12 10 11 10 1 11 10 11 10 10 11 12 1 10 1 10 10 12 1 12 1 10 1 12 0 
0 1 10 1 1 1 12 1 1 1 11 1 1 1 12 1 1 1 11 1 1 1 12 1 11 1 12 1 10 1 1 1 1 1 11 1 1 1 10 1 1 1 10 1 12 1 1 1 12 0 
0 1 10 1 11 12 10 11 10 1 12 10 11 11 12 1 10 11 11 12 12 1 11 11 12 1 11 1 11 1 12 1 12 1 11 1 10 11 11 1 12 1 12 1 10 11 10 1 10 0 
0 1 11 1 1 1 12 1 1 1 11 1 1 1 11 1 1 1 1 1 10 1 1 1 10 1 11 1 1 1 10 1 11 1 11 1 10 1 1 1 10 1 11 1 1 1 12 1 10 0 
0 1 11 10 11 1 12 1 10 12 10 1 11 1 11 11 11 1 12 1 11 11 12 1 12 1 10 12 11 10 12 1 11 10 12 1 11 10 11 11 10 1 11 11 10 1 10 1 12 0 
0 1 12 1 1 1 12 1 10 1 1 1 10 1 1 1 1 1 10 1 1 1 11 1 1 1 11 1 1 1 12 1 1 1 1 1 1 1 1 1 1 1 1 1 11 1 11 1 11 0 
0 1 10 1 12 11 10 1 10 1 11 1 11 11 11 1 10 11 11 12 11 1 12 10 12 11 10 1 10 1 12 11 11 11 11 11 11 12 12 11 11 10 11 12 10 1 11 1 11 0 
0 1 10 1 12 1 1 1 10 1 10 1 1 1 10 1 12 1 1 1 11 1 1 1 1 1 1 1 12 1 1 1 1 1 1 1 1 1 1 1 1 1 1 1 1 1 10 1 11 0 
0 10 11 1 12 1 12 10 10 10 12 1 12 1 12 10 12 1 10 1 11 12 10 10 11 12 12 10 10 12 10 12 10 12 11 12 10 10 12 11 10 10 11 12 11 10 12 1 10 0 
0 1 1 1 11 1 10 1 1 1 12 1 11 1 1 1 1 1 10 1 10 1 1 1 1 1 1 1 1 1 1 1 11 1 1 1 1 1 12 1 1 1 10 1 1 1 12 1 11 0 
0 1 12 12 12 1 10 1 11 1 11 1 10 12 12 12 10 12 11 1 12 12 11 12 10 12 11 11 10 1 11 1 10 1 10 1 12 1 10 1 10 1 10 1 12 10 10 1 12 0 
0 1 12 1 1 1 12 1 10 1 11 1 12 1 1 1 1 1 1 1 10 1 1 1 1 1 1 1 1 1 11 1 11 1 12 1 10 1 10 1 10 1 1 1 11 1 1 1 11 0 
0 1 12 1 11 10 10 1 10 1 11 10 10 1 11 12 10 10 11 12 12 1 10 10 11 1 12 10 12 11 12 11 12 1 11 1 12 1 12 1 12 10 12 11 11 1 11 12 10 0 
0 1 11 1 1 1 1 1 11 1 1 1 10 1 10 1 1 1 1 1 1 1 10 1 1 1 12 1 1 1 11 1 1 1 11 1 11 1 1 1 11 1 1 1 12 1 12 1 10 0 
0 1 12 12 11 11 11 12 12 10 12 1 10 1 10 1 10 1 12 10 12 10 10 11 10 1 12 1 11 1 10 1 12 11 12 1 12 12 10 10 10 1 12 1 10 1 10 1 10 0 
0 1 1 1 1 1 1 1 1 1 10 1 1 1 12 1 12 1 10 1 1 1 1 1 12 1 12 1 12 1 1 1 10 1 11 1 1 1 1 1 1 1 11 1 1 1 12 1 10 0 
0 1 11 10 12 10 10 1 10 1 10 12 11 10 11 1 12 1 12 1 10 12 11 1 11 12 10 1 12 11 10 10 12 1 10 10 12 10 10 10 11 11 10 10 12 10 12 1 10 0 
0 1 10 1 1 1 10 1 10 1 1 1 12 1 11 1 10 1 1 1 11 1 1 1 11 1 1 1 11 1 1 1 1 1 1 1 11 1 1 1 1 1 1 1 1 1 1 1 11 0 
0 12 10 1 12 1 11 1 10 10 10 1 10 1 11 1 11 10 10 11 11 1 10 10 10 1 11 11 10 1 10 10 12 11 10 1 11 12 12 11 12 1 11 1 10 12 12 1 10 0 
0 1 1 1 10 1 1 1 11 1 1 1 1 1 10 1 1 1 11 1 1 1 10 1 1 1 12 1 1 1 11 1 1 1 11 1 1 1 1 1 12 1 10 1 12 1 12 1 11 0 
0 1 11 12 11 11 12 11 11 11 11 12 10 1 10 11 11 1 10 1 11 10 11 1 11 12 11 10 12 1 11 1 11 1 12 11 12 12 11 1 10 11 12 1 12 1 10 1 10 0 
0 1 11 1 1 1 1 1 10 1 1 1 11 1 1 1 12 1 12 1 1 1 11 1 1 1 1 1 1 1 11 1 10 1 1 1 1 1 11 1 11 1 1 1 12 1 11 1 11 0 
0 1 11 1 10 10 11 1 12 1 10 1 11 10 10 11 11 1 12 11 11 1 12 11 12 10 11 10 10 10 10 1 12 10 12 10 12 1 10 1 11 1 12 10 12 1 11 1 11 0 
0 1 1 1 1 1 10 1 1 1 12 1 1 1 1 1 1 1 1 1 12 1 1 1 1 1 1 1 1 1 1 1 1 1 1 1 12 1 1 1 1 1 11 1 1 1 1 1 10 0 
0 10 12 11 12 11 12 11 11 10 11 10 12 11 11 10 12 12 11 10 12 10 11 12 11 11 11 12 10 12 11 11 12 10 11 11 11 12 10 11 12 10 12 11 10 11 12 11 10 0 
0 0 0 0 0 0 0 0 0 0 0 0 0 0 0 0 0 0 0 0 0 0 0 0 0 0 0 0 0 0 0 0 0 0 0 0 0 0 0 0 0 0 0 0 0 0 0 0 0 0 
